11111111111111111111
10000000000000000031
11111111101010111111
10000000101010100001
10005000101010111101
10000000101010000031
10301111101010100001
10000000001010104001
11111110001010100001
10400000000010000001
11111111111011111111
10000000000000000031
10001111111111111101
10001500000000050101
10000000040111000101
10001111111101000101
10000000000001000101
11111111111111000111
13000000000000000001
11111111111111111111